#########################
# #         #           #
# ### ### ### ### ### # #
#       #     #       # #
##  ### ### ### ### ### #
#     #   #   #   # #   #
### # # # ####### # # ###
#   #   # #       # #   #
#   #####   ####### ### #
# #     # #           # #
# # ### # # # # ## ## # #
# #       # # #   #   # #
#   # ##### # # # ##### #
#   # #     #           #
# # # ##### # #  # ######
# # #     # # #     #   #
# # ##### ### # ####### #
# #           #   #     #
#######################Q#
