#######################################################################
# #         #                     #       #   #   #         # #       #
# # ####### # ########### ####### ### ### # # # # ### ##### # # ### ###
#   # #     # #           #     #   # #     #   #   #     # #     #   #
##### # ####### ### ##### # ### ### # ############# ##### # ######### #
#     #   #     #   #   # # # # #     #       #   # #     #         # #
# ### ### # # ### ### # ### # # ##### # ##### # # # # ############# # #
# # #     # #   #   # # #   # #     # #     # # # # # #         #   # #
# # ####### ### ### # # # ### ##### ####### # # ### # # ##### # # ### #
# #   #     # #   # # #   #       # #     # # #   #   #   #   # # #   #
# # # # ##### ### # # ##### ####### # # ### # ### ####### # ##### # ###
# # # #         # # # #     #     # # # #   #   #     #   #     # #   #
# # # ####### ### # # # ### # ### # # # # ##### ### ### ####### # # # #
# # #       # #   # #   #   # #   # # # # #   #   #   #   #   # # # # #
# ### ##### # # ### # ####### # ### # # # # ##### # # ### # # # # ### #
#   # #   #   # #   # #     # #     # #   #     # # #       # #       #
### ### # # ### ##### # ### # ##### # ##### # ### ################### #
#   #   # #   #     # #   #   #   # # #     #   #                   # #
# ### ### ### ##### # ### ##### ### # ####### # ################### ###
# #   # # #   # #   #   #   #       # #     # #             #     #   #
# # # # # # ### # ### ##### # ####### # ### # ####### ##### # ### ### #
# # # # # #     #     #   # # #   #   # #   #   #   #   # #   # # # # #
# # # # # ### ######### # # # # # # ### ### ### # # ### # ##### # # # #
# # # # #   # #   #     #   #   # #   #   # #     #   # #     #     # #
# # # # ### # # # # ################# ### # ########### # # ### ##### #
# # # #   # # # # # #         #     #     #       #     # #   # #     #
# # # ### # ### # # # ####### # ### ############# # ##### ### # # ### #
# # #   # #     #   #   #   #   # #     #       #   #   #   #   # #   #
# # ### # ### ##### ### # ####### ##### # ##### ##### ##### ##### #####
# # # # #   # #   # #   #     #       #       #   # #         # #     #
# # # # ### # # # ### ### # ### ### # ######### # # # ####### # ##### #
# #   #   #   # # #   # # #   # # # #   #       #   # #     #       # #
# ### ### ### # # # ### # ### # # # ### # ########### # ### ######### #
# # # # #   # # #   #     #   #   # # # # #   #     # # #         #   #
# # # # ### # # ########### ##### # # # # # # # ### # # ######### # # #
# #     #   # #   #     #   #   # # #   #   # #   #   #     #   # # # #
# ### ### ####### ### # # ### # # # # ####### ### ######### # # # # # #
#   # #   #     # #   # #     # # # #   #   #     # #     # # #     # #
### # # ### # # # # ### ### ### # # ### # ##### ### # ### # ### #######
#   # #     # # #   #     #   # # #   #   #   #   # # #   #   # #     #
# ### ####### # # ####### ### # # ### ##### # ### # # # ##### ### ### #
#   # #   # # # # #     #   # #   # #   #   #   #   # #     #       # #
### # # # # # ### # ### ### ##### # ### # ##### ### # ##### ######### #
#   # # # # #     # #   # # #   # #   # # #   # #   #   # #     #     #
# ### # # # ####### # ### # # # # ### # # # # # ### ### # ##### # ### #
#   # # #   # #     #   #     # #     # #   # #   #   # #       #   # #
### # # ### # # ####### ####### ##### # ##### ### # ### # ######### # #
# # #   # # # #       #   #   #     # # #     # # # #   # # #       # #
# # ##### # # ####### ### ### ##### ### # ##### # ### ### # # ### ### #
# #     # # #       # # #   #           # #   # #   #   # #     # #   #
# ##### # # # # ##### # ### ############# # # # ### ### # ####### # ###
# #     #   # #     # #   # #     #       # #     #     #     #   #   #
# # ####### ####### # # ### # ### # ####### ### ############# # ##### #
# #       #   #     # #   #   # #   #     #   # #         # # # #     #
# ####### ### # ### # # # ##### ##### ##### # # # ### ### # # # # #####
#   #   # #   # #   # # #       #     #     # # # # #   #   # # # #   #
# # # ### # ### ##### # ### ##### # ### ##### ### # ### ##### # # ### #
# #   #   # #   #     # # # #     #     #     #   #   #     #   #     #
# ##### ### ### # ##### # # # ########### ### # ### # ##### ######### #
# #     #       #   # #   # #   #     # # #   # #   # # #   #         #
# # ############### # ### # ### ### # # # ##### # ### # # ### #########
#                   #     #         #   #         #     #             #
#####################################################################Q#
