#########################
# #         #           #
# ### ### ### ####### # #
#       #     #       # #
####### ### ### ####### #
#     #   #   #   # #   #
### # ### ####### # # ###
#   #   # #       # #   #
#   #####   ####### ### #
# #     # #   #       # #
# # ### # # # # ##### # #
# #       # # #   #   # #
# ### ##### # # # ##### #
#   # #     # # #       #
# # # ##### # # #########
# # #     # # # #   #   #
# # ##### ### # # # ### #
# #           #   #     #
#######################Q#
