MMMMMMMMMMMMMMMMMMMMMMMMMMMMMMMMMMMMMMMM
M00000MMM0MMM0MM00000000M0MMMMMMMMM0000M
M00000MM000000000M0MMMM0000000000000MMMM
M00000M00MMMMMMMMMMMM0MMM0M0MMM0MMM0M0MM
M0MMMMM0M000000MM00M00MMM0MMMMM0M00MM0MM
M0MMMMMMMMMMMM0MM0MMM0MMMMM00000000M00MM
M00000000000000MM0MMM00000MMMMMMMM0MM00M
MMMM0MM0MMMM0MM0M0MMMMMMM0MMM0MMMM0MM0MM
MMMMMMM0000M00M0M0000000000000000000000M
S0000000MMM00MM0M0M0MMMMMM0MMMM0MMMMMM0M
MM0MMMM0MM00MMM0MMMMMMMMMM0MM0M0MMMMMM0M
MMMM0000M00MMMM000MM0000000000M0000M000M
M00M0MM0MM0MM000MMMMMM0MMMMMMMMMMM0MMM0M
MM00MMMMM00000MMM0MMMM00000000000M0MMM0M
M0M0000000M0MMMM0000000MMMMMMMMMMMMMM00M
M0MMMM0MMMM000000MM0MM0M0M000000000MMMMM
M000000MMMM0MMMM0MMMMMMM0MMMMMMMMM00000M
MMMMMM0MM0000MMM0000000000000000000MMMMM
M0000MMMMMMM0MMMMMMMMMMMM0M0MMMMMM0MM0MM
M000000MMMMM0M000000000000M000MMMM00000M
M0000M0000000MMMMMMMM0MMMMMMM0MMMMMMMMMM
MMMMMMMM0MMM0MM00000000MM00000MMMMMMMMMM
MMMM00000M0M000MMMMMMMMMMMMMMM000000000M
S0000MMMMM0MMM0M00M0000MMMMMMM0MMMMMMM0M
MMM0MMM0000M0M000M00M0M000000M0M00000M0M
M0000000MMMM0MMMMMM0M0M000000M0M0MMM0M0M
MMMMM0MMMMMM00000000M0M000000M0M0M0M0M0M
M00000MMMMMMMMMMMMM0MMM000000M0M000M0M0M
MMMMM0000000000000000MM000000M0MMMMM0M0M
MMMMMMMM0MM0MMMMM0MM0M0MMMMM0M0000000M0M
MMM000000M00M00MMMMM000000MM0MMMMMMMMM0M
MMMMMMM0MMM000M000000MMMM00000000000000M
MMMMMMMMMMMMMMMMMMMMMMMMMMMMMMMMMMMMMMMM