###########
#       # #
####### # #
#   #   # #
# # # ### #
# # #     #
### ##### #
#     #   #
# ##### ###
#     #   #
# ### ### #
#   #     #
###########
