#########################
#   #   #           #   #
### ### # ####### # ### #
# #   #   #   #   #   # #
# ### # ### ### ##### # #
#   # # #     #     # # #
# # # # ##### ##### # # #
# # # # #     #   # # # #
# # # # # ### # # # # # #
# #   # # # #   # # #   #
# ##### # # ### ### ### #
#     # # # #   #   #   #
##### # # # # ### ### ###
#   # #   #   # # #     #
# # # ##### ### # #######
# # #   #       #       #
# ##### # ########### # #
# #     # #         # # #
# # ####### ####### ### #
#           #           #
#######################Q#
