#     #   #  # ##
# # # # # ##  # #
# # #  # # #  # #
# #   #    #  # #
# ##   # # # ####
# # # # ## # # ##
####   # # # # # 
# # # # # # # # #
# # # ##### # ###
####       #### #
######### Q #####
